#############################
#A    #       #     #       #
# ### # ### # # ### # ### # #
# #   #   # #   #   #   # # #
# # ##### ##### ##### ### # #
# #     #     #     #   #   #
### ### # ### # ###B# #######
#   #   # #   #   # #     # #
# ### ### # ##### ### ### # #
#   #     #     #     #   # #
# ### ##### ### ##### ### # #
#   #     #   #   #   #   # #
### # ### ### ### # ### ### #
#   #   #   #   # #   #     #
# ##### # ### # # ### ##### #
#     # #   # # #   #     # #
##### # ### # # ### ### # # #
#   # #   # # #   #   # # # #
# # # ### # # ### # # # # # #
# # #   # # #   # # # # #   #
# # ### # # ### # # # # ### #
# #   # # #   # # # # #   # #
# ### # # ### # # # ### # # #
#     #   #   #   #     #   #
#############################