A     #   #  
# ### # ### 
#   #   # # 
### # ### # 
#   #     # 
# ### ### # 
#   #   # # 
### # ### # 
#     #   B 
