#A########
# # ######
#        #
# ###### #
#      # #
###### # #
#      #B#
